0WWWWWWW0000000
00000000W000000
0P000000W000000
00000000W000000
0WWWWWWW0000000