WWWWWWWWWWWWWWWWWWWWWWWWWWWWWWWWWWWWWWWW
W00000000000000000000000000000W000000000
W00000000000000000000000000000W000000000
WP0000S00M0000000M0000L0000000W000000000
W00000000000000000000000000000W000000000
W00000000000000000000000000000W000000000
W0000B000000000000000000D00000W000000000
W00000000M0000000M000000000000W000000000
W00000000000000000000000000000W000000000
W00000000000000000000000000000W000000000
W00000000000000000000000000000W000000000
W00000000000000000000000000000W000000000
W00000000000000000000000000000W000000000
WWWWWWWWWWWWWWWWWWWWWWWWWWWWWWWWWWWWWWWW